11111111111111111111111111111
1ECCCCCCCCCCCCCCCCCCCCCCCCCC1
10100101001000001010010000001
10100100101010100010010000011
10100101001000001010010000001
10100100101010100010010000011
10100101001000001010010000001
10100100101010100010010000011
10100101001000001010010000001
10100100101010100010010000011
10100101001000001010010000001
10100100101010100010010000011
1PCCCCCCCCCCCCCCCCCCCCCCCCCC1
11111111111111111111111111111