11111111111111111111111111111
1ECCCCCCCCCCCCCCCCCCCCCCCCCC1
1C1CC1C1CC1CCCCC1C1CC1CCCCCC1
1C1CC1CC1C1C1C1CCC1CC1CCCCC11
1PCCCCCCCCCCCCCCCCCCCCCCCCCC1
11111111111111111111111111111