11111111111111111111111111111
1PCCCCCCCCCCCCCCCCCCCCCCCCCC1
1010C101001000001010010C00001
1C1001001010101C0010010000011
10100101C01000001010010C00001
1010C100101010100C10010000011
10100101C0100E0010100100000C1
1010010C10101010001C010000011
1010C1010010000C1010010000001
101001001C10101000100100C0011
1010010100100C001C10010000001
1010C100101010100010010C00011
1CCCCCCCCCCCCCCCCCCCCCCCCCCC1
11111111111111111111111111111